11111111111111111111111111111
1E00B00000C00000C0000B0000001
10100101001000101000000010101
10101010101010001000000010101
1P0000000C00C000000000B0000C1
11111111111111111111111111111
